######
#    #
# PX #
#   O#
######