############
# O        #
#   P      #
#       ####
#          #
############